*#******************
*###########********
*#*****~***######"**
*"######********#***
*****#*****#####~***
*****###%###***#****
****##*********#****
****#****?*****#****
****######*****##***
****#***********#***
****#********####*%*
*####********"****#*
*#**~********######*
*%**####?*^###******
********************
