*#******************
*#***#####"#********
*#####*****##~******
*****#**************
*****%**************
*****######"********
*~####**************
*****#**************
*****######*********
*****#****#*********
*****#****^*********
*****#**************
*****##***?*********
******#####*********
********************
