*#*****#####?*******
*#*#"#*#**#*********
*###*###**#~********
*******#***#####%***
***####%*******#****
***#***********#****
***#****########****
***#******#****?****
***###%####******%**
***#****#********#**
***#**?*##########**
***"**#*"******#*#**
***#**#***%*^*~#*#**
***##########**###**
********************
